111111111
1C00000C1
1000PE001
100000001
1C00000C1
111111111